50000000000000000000000000000000000000000000000000000000000000000000000000000000000000000000000
50000000000000000000000000000000000000000000000000000000000000000000000000000000000000000000000
50000000000000000000000000000000000000000000000000000000000000000000000000000000000000000000000
50000000000000000000000000000000000000000000000000000000000000000000000000000000000000000000000
50000000000000000000000000000000000000000000000000000000000000000000000000000000000000000000000
50000000000000000000000000000000000000000000000000000000000000000000000000000000000000000000000
50000000000000000000000000000000000000000000000000000000000000000000000000000000000000000000000
50000000000000000000000000000000000000000000000000000000000000000000000000000000000000000000000
50000000000000000000000000000000000000000000000000000000000000000000000000000000000000000000000
50000000000000000000000000000122222222222230000000000000000000000000000000000000000000000000000
50000000000000000000000000000455555555555560000000000000000000000000000000000000000000000000000
00000000000000000000000000000788888888888890000000000000000000000000000000000000000000000000000
22222222222300000000000000000000000000000000000000000000000000000000000000000000000000000000000
55555555555600000000000000000000000000000000000000000000000000000000000000000000000000000000000
55555555555600000000000000000000000000000000000000000000000000000000000000000000000000000000000
55555555555520000000000000000000000000000000000000000000000000000000000000000000000000000000000